OKC CoCo
An Interactive Fiction by Tim Gourley
Release 1 / Serial number 100127 / Inform 7 build 5Z71 (I6/v6.31 lib 6/12N) SD

Shared Lobby
The lobby echoes and feels cold. It opens to several business but the only one of interest to you is the Oklahoma City Coworking Collaborative, to the north of the lobby. The door stands open and you feel an almost magnetic urge to enter and take part in the magical wonders within.

>north
Social Area
The CoCo's social area feels open and colorful. Several paintings and photographs from local artists hang on the inner walls while the windows on the outer walls allow ample light to enter the space. It feels welcoming and open. A divider partially hides the meeting space to the east, to the west is an impenetrable door to the fixed desk area, and to the south is the shared lobby.

You can see a shiny door here.

>examine door
The door is made of reinforced glass and looks to be impregnable. You see someone sitting alone on the other side. A complex biometric key mechanism stands between you and finding out who the person is.

>open door
It seems to be locked.

>unlock door
You can't unlock the door from this side without some sort of key...

>east
Meeting Space
The meeting space contains several rows of tables and chairs. A podium is set up for a presenter to give various talks. You especially want to hear that sexy Tim Gourley give his talk at the next Geek Writers meeting. You can see the Social Area to the west.

You can see a suspicious panel and a laptop bag (closed) here.

>examine panel
A small panel looks discolored and slightly out of place. It is like you can tug on it to open it. Maybe it leads somewhere?

>examine bag
You can't see inside, since the laptop bag is closed.

>open bag
You open the laptop bag, revealing a Macbook and a biometric keycard.

>examine bag
In the laptop bag are a Macbook and a biometric keycard.

>examine macbook
There is a sticker on the Macbook reading, "Property of Chad Henderson". The Macbook feels evil. You instinctively know it is used as part of a plot to take over the world.

>examine keycard
The biometric keycard hums softly as you hold it. It contains the 3D holograph of an iris. It looks like it is a very important keycard!

>get keycard
Taken.

>west
Social Area
You can see a shiny door here.

>unlock door
You unlock the shiny door.

>open door
You open the shiny door.

>enter door
Fixed Desk Area
The Fixed Desk Area is a place of magic and wonders! You now feel complete that you have made it this far. The aura of puppies, unicorns, narwhals, and sizzling bacon surrounds you.

You can see a shiny door and Chad Henderson here.

Have you seen my Macbook? I need it to help me take over the world.

>examine chad
You see nothing special about Chad Henderson.

Have you seen my Macbook? I need it to help me take over the world.

>enter panel
You can't see any such thing.

>enter door
Social Area
You can see a shiny door here.

>look
Social Area
The CoCo's social area feels open and colorful. Several paintings and photographs from local artists hang on the inner walls while the windows on the outer walls allow ample light to enter the space. It feels welcoming and open. A divider partially hides the meeting space to the east, to the west is an impenetrable door to the fixed desk area, and to the south is the shared lobby.

You can see a shiny door here.

>east
Meeting Space
You can see a suspicious panel and a laptop bag (in which is a Macbook) here.

>get macbook
Taken.

>west
Social Area
You can see a shiny door here.

>enter door
Fixed Desk Area
You can see a shiny door and Chad Henderson here.

Chad looks at you and says, "I have a Macbook just like that! I plan on using it to take over the world."

>attack chad
What good would that accomplish?

Chad looks at you and says, "I have a Macbook just like that! I plan on using it to take over the world."

>enter door
Social Area
You can see a shiny door here.

>west
You can't go that way.

>east
Meeting Space
You can see a suspicious panel and a laptop bag (empty) here.

>open panel
You open the suspicious panel.

>enter panel
Long Tunnel
The tunnel stretches out for what seems miles. It is faintly illuminated from some unknown source, but the amount of dust and cobwebs obscures your vision. You hear a faint sound coming from a distance. As you travel down the tunnel, you see a drop-off leading down, with a small rope ladder bolted in place. Should you head down?

You can see a suspicious panel here.

>down
Antechamber
The tunnel opens up into an antechamber filled with arboresque furniture. An antique turntable plays a recording long forgotten. Someone must have been here recently to put the record on, but the room looks deserted now. The antechamber splits off into two hallways: one to the north and one to the south.

>south
Armory
Various armaments line the walls on display. It looks like a scene out of Buffy the Vampire Slayer in here! In the center of the room rests a glowing sword that calls out to you.

You can see a glowing sword here.

>get sword
Taken.

>examine sword
The sword emanates a power unlike any you have ever seen. It could likely be used to dispatch those trying to take over the world.

>north
Antechamber

>up
Long Tunnel
You can see a suspicious panel here.

>enter panel
Meeting Space
You can see a suspicious panel and a laptop bag (empty) here.

>west
Social Area
You can see a shiny door here.

* * *

>enter door
Fixed Desk Area
You can see a shiny door and Chad Henderson here.

Chad looks at you and says, "I have a Macbook just like that! I plan on using it to take over the world."

>attack chad
Is it really worth slaying Chad with your sword for no good reason?

Chad looks at you and says, "I have a Macbook just like that! I plan on using it to take over the world."

>enter door
Social Area
You can see a shiny door here.

>attack macbook
You smash the Macbook to a million little pieces! The owner is going to be PISSED but the world has been saved!

>inv
You are carrying:
  a glowing sword
  a smashed remnant of an evil Macbook.
  a biometric keycard

>enter door
Fixed Desk Area
You can see a shiny door and Chad Henderson here.

Chad looks at you with anger, but noticing your sword he backs down. "My plans to take over the world have been thwarted! But I still remain free to sow chaos on the world!"

>attack chad
Chad rises up to attack but you slay the mighty beast, ending his reign of terror once and for all!

    *** You have won ***

Would you like to RESTART, RESTORE a saved game, or QUIT?

* * *

>north
Social Area
The CoCo's social area feels open and colorful. Several paintings and photographs from local artists hang on the inner walls while the windows on the outer walls allow ample light to enter the space. It feels welcoming and open. A divider partially hides the meeting space to the east, to the west is an impenetrable door to the fixed desk area, and to the south is the shared lobby.

You can see a shiny door here.

>east
Meeting Space
The meeting space contains several rows of tables and chairs. A podium is set up for a presenter to give various talks. You especially want to hear that sexy Tim Gourley give his talk at the next Geek Writers meeting.

You can see a suspicious panel and a laptop bag (closed) here.

>open panel
You open the suspicious panel.

>enter panel
Long Tunnel
The tunnel stretches out for what seems miles. It is faintly illuminated from some unknown source, but the amount of dust and cobwebs obscures your vision. You hear a faint sound coming from a distance. As you travel down the tunnel, you see a dropoff leading down, with a small rope ladder bolted in place. Should you head down?

You can see a suspicious panel here.

>down
Antechamber
The tunnel opens up into an antechamber filled with arboresque furniture. An antique turntable plays a recording long forgotten. Someone must have been here recently to put the record on, but the room looks deserted now. The antechamber splits off into two hallways: one to the north and one to the south.

* * *

>get sword
Taken.

>inv
You are carrying:
  a glowing sword

>north
Antechamber

* * *

>up
Long Tunnel
You can see a suspicious panel here.

>enter panel
Meeting Space
You can see a suspicious panel and a laptop bag (closed) here.

>open bag
You open the laptop bag, revealing a Macbook and a biometric keycard.

>get keycard
Taken.

* * *

>east
Meeting Space
The meeting space contains several rows of tables and chairs. A podium is set up for a presenter to give various talks. You especially want to hear that sexy Tim Gourley give his talk at the next Geek Writers meeting.

You can see a suspicious panel and a laptop bag (closed) here.

>examine panel
A small panel looks discolored and slightly out of place. It is like you can tug on it to open it. Maybe it leads somewhere?

* * *

>examine bag
You can't see inside, since the laptop bag is closed.

>look bag
I only understood you as far as wanting to look.

>look
Meeting Space
The meeting space contains several rows of tables and chairs. A podium is set up for a presenter to give various talks. You especially want to hear that sexy Tim Gourley give his talk at the next Geek Writers meeting.

You can see a suspicious panel and a laptop bag (closed) here.

>inv
You are carrying nothing.

>open bag
You open the laptop bag, revealing a Macbook and a biometric keycard.

>get macbook
Taken.

>get keycard
Taken.

>open panel
You open the suspicious panel.

* * *

>enter panel
Long Tunnel
The tunnel stretches out for what seems miles. It is faintly illuminated from some unknown source, but the amount of dust and cobwebs obscures your vision. You hear a faint sound coming from a distance. As you travel down the tunnel, you see a dropoff leading down, with a small rope ladder bolted in place. Should you head down?

You can see a suspicious panel here.

>south
You can't go that way.

>down
Antechamber
The tunnel opens up into an antechamber filled with arboresque furniture. An antique turntable plays a recording long forgotten. Someone must have been here recently to put the record on, but the room looks deserted now. The antechamber splits off into two hallways: one to the north and one to the south.

>south
Armory
Various armaments line the walls on display. It looks like a scene out of Buffy the Vampire Slayer in here! In the center of the room rests a glowing sword that calls out to you.

The sword emenates a power unlike any you have ever seen.

>examine sword
You see nothing special about the glowing sword.

>get sword
Taken.

>get sword
You already have that.

>examine sword
You see nothing special about the glowing sword.

>north
Antechamber

* * *

>unlock door
You unlock the shiny door.

>enter door
You can't, since the shiny door is in the way.

>open door
You open the shiny door.

>enter door
Fixed Desk Area
The Fixed Desk Area is a place of magic and wonders! You now feel complete that you have made it this far. You suddenly feel as if everything is going to be alright.

You can see a shiny door and Chad Henderson here.

>attack chad
Is it really worth slaying Chad with your sword for no good reason?

>drop sword
Dropped.

>attack chad
What good would that accomplish?

>get sword
Taken.

>drop macbook
Dropped.

>attack macbook
You smash the Macbook to a million little pieces! The owner is going to be PISSED!

Chad admires your sword.

>look
Fixed Desk Area
The Fixed Desk Area is a place of magic and wonders! You now feel complete that you have made it this far. You suddenly feel as if everything is going to be alright.

You can see a smashed remnant of a Macbook., a shiny door, and Chad Henderson here.

Chad admires your sword.

>get macbook
Taken.

Chad looks at you with anger, but noticing your sword he backs down.

>drop macbook
Dropped.

Chad admires your sword.

>attack chad
Chad admires your sword.

>look
Fixed Desk Area
The Fixed Desk Area is a place of magic and wonders! You now feel complete that you have made it this far. You suddenly feel as if everything is going to be alright.

You can see a smashed remnant of a Macbook., a shiny door, and Chad Henderson here.

Chad admires your sword.

* * *

>get macbook
Taken.

Chad looks at you with anger, but noticing your sword he backs down.

>inv
You are carrying:
  a smashed remnant of a Macbook.
  a glowing sword
  a biometric keycard

Chad looks at you with anger, but noticing your sword he backs down.

>look
Fixed Desk Area
The Fixed Desk Area is a place of magic and wonders! You now feel complete that you have made it this far. You suddenly feel as if everything is going to be alright.

You can see a shiny door and Chad Henderson here.

Chad looks at you with anger, but noticing your sword he backs down.

>drop macbook
Dropped.

Chad admires your sword.

>drop sword
Dropped.

"If I ever find out who destroyed my Macbook", Chad fumes with a vein pulsing on his forehead, "I will kill them with my bare hands!"

>attack chad
You wail on Chad with your wimpy slaps but he only laughs and destroys you with his mind.

    *** You have died ***

Would you like to RESTART, RESTORE a saved game, or QUIT?

* * *

>get macbook
Taken.

Chad looks at you with anger, but noticing your sword he backs down.

>attack chad
Chad rises up to attack but you slay the mighty beast, ending his reign of terror once and for all!

    *** You have won ***

Would you like to RESTART, RESTORE a saved game, or QUIT?

* * *

>north
Social Area
The CoCo's social area feels open and colorful. Several paintings and photographs from local artists hang on the inner walls while the windows on the outer walls allow ample light to enter the space. It feels welcoming and open. A divider partially hides the meeting space to the east, to the west is an impenetrable door to the fixed desk area, and to the south is the shared lobby.

You can see a shiny door here.

>open door
It seems to be locked.

* * *

>unlock door
You can't unlock the door from this side without some sort of key...

>east
Meeting Space
The meeting space contains several rows of tables and chairs. A podium is set up for a presenter to give various talks. You especially want to hear that sexy Tim Gourley give his talk at the next Geek Writers meeting.

You can see a suspicious panel and a laptop bag (closed) here.

>open bag
You open the laptop bag, revealing a Macbook and a biometric keycard.

* * *

>get keycard
Taken.

>examine macbook
There is a sticker on the Macbook reading, "Property of Chad Henderson".

>examine keycard
The biometric keycard hums softly as you hold it. It contains the 3D holograph of an iris. It looks like it is a very important keycard!

>open panel
You open the suspicious panel.

>examine panel
You see nothing special about the suspicious panel.

>enter panel
Long Tunnel
The tunnel stretches out for what seems miles. It is faintly illuminated from some unknown source, but the amount of dust and cobwebs obscures your vision. You hear a faint sound coming from a distance. As you travel down the tunnel, you see a dropoff leading down, with a small rope ladder bolted in place. Should you head down?

You can see a suspicious panel here.

* * *

>get sword
Taken.

>north
Antechamber

* * *

>open door
You open the shiny door.

>attack macbook
You smash the Macbook to a million little pieces! The owner is going to be PISSED!

>enter door
Fixed Desk Area
The Fixed Desk Area is a place of magic and wonders! You now feel complete that you have made it this far. You suddenly feel as if everything is going to be alright.

You can see a shiny door and Chad Henderson here.

Chad looks at you with anger, but noticing your sword he backs down.

>attack chad with sword
I only understood you as far as wanting to attack Chad Henderson.

>attack chad with the sword
I only understood you as far as wanting to attack Chad Henderson.

>attack chad
Chad rises up to attack but you slay the mighty beast, ending his reign of terror once and for all!

    *** You have won ***

Would you like to RESTART, RESTORE a saved game, or QUIT?

* * *

OKC CoCo
An Interactive Fiction by Tim Gourley
Release 1 / Serial number 100127 / Inform 7 build 5Z71 (I6/v6.31 lib 6/12N) SD

Shared Lobby
The lobby echoes and feels cold. It opens to several business but the only one of interest to you is the Oklahoma City Coworking Collaborative, to the north of the lobby. The door stands open and you feel an almost magnetic urge to enter and take part in the magical wonders within.

>south
Social Area
The CoCo's social area feels open and colorful. Several paintings and photographs from local artists hang on the inner walls while the windows on the outer walls allow ample light to enter the space. It feels welcoming and open. A divider partially hides the meeting space to the east, and to the west is an impenetrable door to the fixed desk area.

You can see a shiny door here.

>open door
It seems to be locked.

* * *

>unlock door
You can't unlock the door from this side without some sort of key...

>attack door
Violence isn't the answer to this one.

>east
Meeting Space
The meeting space contains several rows of tables and chairs. A podium is set up for a presenter to give various talks. You especially want to hear that sexy Tim Gourley give his talk at the next Geek Writers meeting.

You can see a laptop bag (closed) here.

>get laptop bag
Maeghan glares at you from her desk and you suddenly feel compelled to not take the bag. But maybe rummaging through it will be ok?

>open bag
You open the laptop bag, revealing a Macbook and a biometric keycard.

* * *

>get macbook
Taken.

>examine macbook
There is a sticker on the Macbook reading, "Property of Derrick Parkhurst".

>drop macbook
Dropped.

>attack macbook
You smash the Macbook to a million little pieces! The owner is going to be PISSED!

>look
Meeting Space
The meeting space contains several rows of tables and chairs. A podium is set up for a presenter to give various talks. You especially want to hear that sexy Tim Gourley give his talk at the next Geek Writers meeting.

You can see a laptop bag (in which is a biometric keycard) here.

>get keycard
Taken.

>close bag
You close the laptop bag.

>look
Meeting Space
The meeting space contains several rows of tables and chairs. A podium is set up for a presenter to give various talks. You especially want to hear that sexy Tim Gourley give his talk at the next Geek Writers meeting.

You can see a laptop bag (closed) here.

>examine keycard
The biometric keycard hums softly as you hold it. It contains the 3D holograph of an iris. It looks like it is a very important keycard!

>west
Social Area
You can see a shiny door here.

* * *

>open door
You open the shiny door.

>enter door
Fixed Desk Area
The Fixed Desk Area is a place of magic and wonders! You now feel complete that you have made it this far. You suddenly feel as if everything is going to be alright.

You can see a shiny door and Derrick Parkhurst here.

"If I ever find out who destroyed my Macbook", Derrick fumes with a vein pulsing on his forehead, "I will kill them with my bare hands!"

>lock door
With the press of a button and the beeps of electronics, the shiny door is now locked.

"If I ever find out who destroyed my Macbook", Derrick fumes with a vein pulsing on his forehead, "I will kill them with my bare hands!"

* * *

>unlock door
You can't unlock the door from this side without some sort of key...

>east
Meeting Space
The meeting space contains several rows of tables and chairs. A podium is set up for a presenter to give various talks. You especially want to hear that sexy Tim Gourley give his talk at the next Geek Writers meeting.

You can see a laptop bag (closed) here.

>open bag
You open the laptop bag, revealing a Macbook and a biometric keycard.

>get bag
Maeghan glares at you from her desk and you suddenly feel compelled to not take the bag. But maybe rummaging through it will be ok?

>get macbook
Taken.

* * *

>enter door
Fixed Desk Area
The Fixed Desk Area is a place of magic and wonders! You now feel complete that you have made it this far. You suddenly feel as if everything is going to be alright.

You can see a shiny door and Chad Henderson here.

>attack macbook
You smash the Macbook to a million little pieces! The owner is going to be PISSED!

Chad charges at you screaming, "It was YOU! YOU broke my Macbook!" Lasers shoot from his eyes, rendering you dead.
"If I ever find out who destroyed my Macbook", Chad fumes with a vein pulsing on his forehead, "I will kill them with my bare hands!"

    *** You have died ***

Would you like to RESTART, RESTORE a saved game, or QUIT?

* * *

>unlock door
You can't unlock the door from this side without some sort of key...

>west
You can't go that way.

>east
Meeting Space
The meeting space contains several rows of tables and chairs. A podium is set up for a presenter to give various talks. You especially want to hear that sexy Tim Gourley give his talk at the next Geek Writers meeting.

You can see a laptop bag (closed) here.

>get bag
Maeghan glares at you from her desk and you suddenly feel compelled to not take the bag. But maybe rummaging through it will be ok?

>open bag
You open the laptop bag, revealing a Macbook and a biometric keycard.

>look
Meeting Space
The meeting space contains several rows of tables and chairs. A podium is set up for a presenter to give various talks. You especially want to hear that sexy Tim Gourley give his talk at the next Geek Writers meeting.

You can see a laptop bag (in which are a Macbook and a biometric keycard) here.

>examine macbook
There is a sticker on the Macbook reading, "Property of Derrick Parkhurst".

>get macbook
Taken.

>eat macbook
That's plainly inedible.

>drop macbook
Dropped.

>kick macbook
That's not a verb I recognize.

>look
Meeting Space
The meeting space contains several rows of tables and chairs. A podium is set up for a presenter to give various talks. You especially want to hear that sexy Tim Gourley give his talk at the next Geek Writers meeting.

You can see a Macbook and a laptop bag (in which is a biometric keycard) here.

>get keycard
Taken.

>examine keycard
The biometric keycard hums softly as you hold it. It contains the 3D holograph of an iris. It looks like it is a very important keycard!

>put macbook in bag
You need to be holding the Macbook before you can put it into something else.

>get macbook
Taken.

>put macbook in bag
You put the Macbook into the laptop bag.

>close bag
You close the laptop bag.

* * *

>look
Meeting Space
The meeting space contains several rows of tables and chairs. A podium is set up for a presenter to give various talks. You especially want to hear that sexy Tim Gourley give his talk at the next Geek Writers meeting.

You can see a laptop bag (closed) here.

>west
Social Area
You can see a shiny door here.

>open door
It seems to be locked.

>unlock door
You unlock the shiny door.

>look
Social Area
The CoCo's social area feels open and colorful. Several paintings and photographs from local artists hang on the inner walls while the windows on the outer walls allow ample light to enter the space. It feels welcoming and open. A divider partially hides the meeting space to the east, and to the west is an impenetrable door to the fixed desk area.

You can see a shiny door here.

>west
You can't go that way.

>enter door
You can't, since the shiny door is in the way.

>enter shiny door
You can't, since the shiny door is in the way.

>open shiny door
You open the shiny door.

>enter door
Fixed Desk Area
The Fixed Desk Area is a place of magic and wonders! You now feel complete that you have made it this far. You suddenly feel as if everything is going to be alright.

You can see a shiny door and Derrick Parkhurst here.

>give keycard derrick
You can only do that to something animate.

>give keycard to derrick
Derrick Parkhurst doesn't seem interested.

>kick derrick
That's not a verb I recognize.

>kill derrick
Violence isn't the answer to this one.

>wear derrick
(first taking Derrick Parkhurst)
I don't suppose Derrick Parkhurst would care for that.

>take derrick
I don't suppose Derrick Parkhurst would care for that.

>talk derrick
That's not a verb I recognize.

>talk to derrick
That's not a verb I recognize.

* * *

>south
Social Area
The CoCo's social area feels open and colorful. Several paintings and photographs from local artists hang on the inner walls while the windows on the outer walls allow ample light to enter the space. It feels welcoming and open. A divider partially hides the meeting space to the east, and to the west is an impenetrable door to the fixed desk area.

You can see a shiny door here.

>exits
That's not a verb I recognize.

>directions
That's not a verb I recognize.

>examine social area
You can't see any such thing.

>look
Social Area
The CoCo's social area feels open and colorful. Several paintings and photographs from local artists hang on the inner walls while the windows on the outer walls allow ample light to enter the space. It feels welcoming and open.

>east
Meeting Space
The meeting space contains several rows of tables and chairs. A podium is set up for a presenter to give various talks. You especially want to hear that sexy Tim Gourley give his talk at the next Geek Writers meeting.

>west
Social Area

>north
Shared Lobby

>south
Social Area

>look
Social Area
The CoCo's social area feels open and colorful. Several paintings and photographs from local artists hang on the inner walls while the windows on the outer walls allow ample light to enter the space. It feels welcoming and open.

* * *

>south
Social Area
The CoCo's social area feels open and colorful. Several paintings and photographs from local artists hang on the inner walls while the windows on the outer walls allow ample light to enter the space. It feels welcoming and open. A divider partially hides the meeting space to the east, and to the west is an impenetrable door to the fixed desk area.

You can see a shiny door here.

>west
You can't go that way.

>take derrick
I don't suppose Derrick Parkhurst would care for that.

>kill derrick
Violence isn't the answer to this one.

>dance with derrick
That's not a verb I recognize.

* * *

>west
You can't go that way.

>east
Social Area
You can see a shiny door here.

* * *

>west
You can't go that way.

>open door
It seems to be locked.

>unlock door
(with the shiny door)
(first taking the shiny door)
That's fixed in place.

>unlock door with keycard
You can't see any such thing.

* * *

>south
Social Area
The CoCo's social area feels open and colorful. Several paintings and photographs from local artists hang on the inner walls while the windows on the outer walls allow ample light to enter the space. It feels welcoming and open. A divider partially hides the meeting space to the east, and to the west is an impenetrable door to the fixed desk area.

You can see a shiny door here.

>east
Meeting Space
The meeting space contains several rows of tables and chairs. A podium is set up for a presenter to give various talks. You especially want to hear that sexy Tim Gourley give his talk at the next Geek Writers meeting.

You can see a laptop bag (closed) here.

>open back
You can't see any such thing.

>open bag
You open the laptop bag, revealing a Macbook and a biometric keycard.

* * *

>get macbook
Taken.

>drop macbook
Dropped.

* * *

>attack macbook
You smash the Macbook to a million little pieces! The owner is going to be PISSED!

>look
Meeting Space
The meeting space contains several rows of tables and chairs. A podium is set up for a presenter to give various talks. You especially want to hear that sexy Tim Gourley give his talk at the next Geek Writers meeting.

You can see a smashed remnant of a Macbook. and a laptop bag (in which is a biometric keycard) here.

* * *

>close bag
You close the laptop bag.

>west
Social Area
You can see a shiny door here.

* * *

>open door
You open the shiny door.

>enter door
Fixed Desk Area
The Fixed Desk Area is a place of magic and wonders! You now feel complete that you have made it this far. You suddenly feel as if everything is going to be alright.

You can see a shiny door and Derrick Parkhurst here.

* * *

>attack macbook
You smash the Macbook to a million little pieces! The owner is going to be PISSED!

>look
Meeting Space
The meeting space contains several rows of tables and chairs. A podium is set up for a presenter to give various talks. You especially want to hear that sexy Tim Gourley give his talk at the next Geek Writers meeting.

You can see a smashed pieces of a Macbook. and a laptop bag (in which is a biometric keycard) here.

>get keycard
Taken.

* * *

>open door
You open the shiny door.

>enter door
Fixed Desk Area
The Fixed Desk Area is a place of magic and wonders! You now feel complete that you have made it this far. You suddenly feel as if everything is going to be alright.

You can see a shiny door and Chad Henderson here.

"If I ever find out who destroyed my Macbook", Chad fumes with a vein pulsing on his forehead, "I will kill them with my bare hands!"

>enter door
Social Area
You can see a shiny door here.

* * *

>west
You can't go that way.

>east
Meeting Space
You can see a smashed pieces of a Macbook. and a laptop bag (empty) here.

>get macbook
Taken.

* * *

>west
Social Area
You can see a shiny door here.

>enter door
Fixed Desk Area
You can see a shiny door and Chad Henderson here.

Chad charges at you screaming, "It was YOU! YOU broke my Macbook!" Lasers shoot from his eyes, rendering you dead.

    *** You have died ***

Would you like to RESTART, RESTORE a saved game, or QUIT?

* * *

>east
Meeting Space
The meeting space contains several rows of tables and chairs. A podium is set up for a presenter to give various talks. You especially want to hear that sexy Tim Gourley give his talk at the next Geek Writers meeting.

You can see a laptop bag (closed) here.

>get bag
Meaghan glares at you from her desk and you suddenly feel compelled to not take the bag. But maybe rummaging through it will be ok?

>look
Meeting Space
The meeting space contains several rows of tables and chairs. A podium is set up for a presenter to give various talks. You especially want to hear that sexy Tim Gourley give his talk at the next Geek Writers meeting.

You can see a laptop bag (closed) here.

>open bag
You open the laptop bag, revealing a Macbook and a biometric keycard.

>open bag
That's already open.

>get macbook
Taken.

>inv
You are carrying:
  a Macbook

>get keycard
Taken.

>look keycard
I only understood you as far as wanting to look.

>examine keycard
The biometric keycard hums softly as you hold it. It contains the 3D holograph of an iris. It looks like it is a very important keycard!

>examine macbook
There is a sticker on the Macbook reading, "Property of Derrick Parkhurst".

* * *

>drop macbook
Dropped.

>look
Meeting Space
The meeting space contains several rows of tables and chairs. A podium is set up for a presenter to give various talks. You especially want to hear that sexy Tim Gourley give his talk at the next Geek Writers meeting.

You can see a Macbook and a laptop bag (empty) here.

>get macbook
Taken.